###############
#~~~~~~~~~~~~##
#~~~~~~~~~~~g##
#~~~~~~~~~#####
##~~~~~~~~~~~##
##~~###~~~~~~##
#########~~~~##
###~~~~~~~~~~##
#p~~~~~~~~~~~##
###############