###############
#~~~~~~~~~~~~~#
#g~~~~~~~~~~~~#
####~~~~~~~~###
####~~~##~~~~~#
#~~~~~~##~~~~~#
####~~~~~~~####
####~~~~~~~~~~#
##########~~~~#
#~~~~#######~~#
#~~~~###~###~~#
#~~~~#######~~#
#~~~~##~~~##~~#
#~~~~~~~~~~~~~#
#~~~~~~~~~~~~~#
#~~~~~#########
#~~~~~~~~~~~~~#
####~~~~~~~~~~#
#######~~~~~~~#
##########~~~~#
########~~~~~~#
###~~###~~~~###
###~~###~~~~###
###~~###~~~~###
###~~~~~~~~~###
###p~~~~~~~~###
###############