###############
##~~~~~g~~~~~##
##~~~~~~~~~~~##
#####~~~~~#####
##~~~~~~~~~~~##
##~~~~~#~~~~~##
##~~~~~#~~~~~##
##~~~~~#~~~~~##
##p~~~~#~~~~~##
###############